{
  "name": "PS17",
  "vendorProductId": 1095434261,
  "macros": ["", "", "", "", "", "", "", "", "", "", "", "", "", "", "", ""],
  "layers": [
    [
      "C(KC_TAB)",
      "C(KC_W)",
      "C(S(KC_TAB))",
      "KC_NO",
      "TO(2)",
      "KC_PSLS",
      "KC_PAST",
      "KC_PMNS",
      "KC_P7",
      "KC_P8",
      "KC_P9",
      "KC_PPLS",
      "KC_P4",
      "KC_P5",
      "KC_P6",
      "KC_NO",
      "KC_P1",
      "KC_P2",
      "KC_P3",
      "KC_PENT",
      "KC_P0",
      "KC_NO",
      "KC_PDOT",
      "KC_NO"
    ],
    [
      "KC_RGHT",
      "KC_TRNS",
      "KC_LEFT",
      "KC_NO",
      "TO(0)",
      "KC_TRNS",
      "KC_TRNS",
      "KC_NLCK",
      "KC_TRNS",
      "KC_TRNS",
      "KC_TRNS",
      "KC_BSPC",
      "TO(5)",
      "KC_TRNS",
      "KC_TRNS",
      "KC_NO",
      "TO(2)",
      "TO(3)",
      "TO(4)",
      "KC_TRNS",
      "RESET",
      "KC_NO",
      "KC_TRNS",
      "KC_NO"
    ],
    [
      "USER00",
      "KC_TRNS",
      "USER01",
      "KC_NO",
      "TO(0)",
      "KC_WWW_REFRESH",
      "KC_WWW_HOME",
      "C(S(KC_B))",
      "C(S(KC_TAB))",
      "KC_UP",
      "C(KC_TAB)",
      "USER04",
      "KC_LEFT",
      "KC_DOWN",
      "KC_RGHT",
      "KC_NO",
      "USER05",
      "LWIN(KC_F4)",
      "KC_SLCK",
      "KC_NLCK",
      "KC_F13",
      "KC_NO",
      "KC_F14",
      "KC_NO"
    ],
    [
      "USER00",
      "KC_TRNS",
      "USER01",
      "KC_NO",
      "TO(0)",
      "KC_WWW_REFRESH",
      "KC_HOME",
      "C(KC_T)",
      "C(S(KC_TAB))",
      "KC_UP",
      "C(KC_TAB)",
      "C(KC_W)",
      "KC_LEFT",
      "KC_DOWN",
      "KC_RGHT",
      "KC_NO",
      "KC_WWW_BACK",
      "KC_SPC",
      "KC_WWW_FORWARD",
      "KC_ENT",
      "KC_PGDN",
      "KC_NO",
      "KC_PGUP",
      "KC_NO"
    ],
    [
      "KC_TRNS",
      "KC_TRNS",
      "KC_TRNS",
      "KC_NO",
      "KC_TRNS",
      "KC_TRNS",
      "KC_TRNS",
      "KC_TRNS",
      "KC_TRNS",
      "KC_TRNS",
      "KC_TRNS",
      "KC_TRNS",
      "KC_TRNS",
      "KC_TRNS",
      "KC_TRNS",
      "KC_NO",
      "KC_TRNS",
      "KC_TRNS",
      "KC_TRNS",
      "KC_TRNS",
      "KC_TRNS",
      "KC_NO",
      "KC_TRNS",
      "KC_NO"
    ],
    [
      "KC_TRNS",
      "KC_TRNS",
      "KC_TRNS",
      "KC_NO",
      "KC_TRNS",
      "KC_TRNS",
      "KC_TRNS",
      "KC_TRNS",
      "KC_TRNS",
      "KC_TRNS",
      "KC_TRNS",
      "KC_TRNS",
      "KC_TRNS",
      "KC_TRNS",
      "KC_TRNS",
      "KC_NO",
      "KC_TRNS",
      "KC_TRNS",
      "KC_TRNS",
      "KC_TRNS",
      "KC_TRNS",
      "KC_NO",
      "KC_TRNS",
      "KC_NO"
    ],
    [
      "KC_TRNS",
      "KC_TRNS",
      "KC_TRNS",
      "KC_NO",
      "KC_TRNS",
      "KC_TRNS",
      "KC_TRNS",
      "KC_TRNS",
      "KC_TRNS",
      "KC_TRNS",
      "KC_TRNS",
      "KC_TRNS",
      "KC_TRNS",
      "KC_TRNS",
      "KC_TRNS",
      "KC_NO",
      "KC_TRNS",
      "KC_TRNS",
      "KC_TRNS",
      "KC_TRNS",
      "KC_TRNS",
      "KC_NO",
      "KC_TRNS",
      "KC_NO"
    ],
    [
      "KC_TRNS",
      "KC_TRNS",
      "KC_TRNS",
      "KC_NO",
      "KC_TRNS",
      "KC_TRNS",
      "KC_TRNS",
      "KC_TRNS",
      "KC_TRNS",
      "KC_TRNS",
      "KC_TRNS",
      "KC_TRNS",
      "KC_TRNS",
      "KC_TRNS",
      "KC_TRNS",
      "KC_NO",
      "KC_TRNS",
      "KC_TRNS",
      "KC_TRNS",
      "KC_TRNS",
      "KC_TRNS",
      "KC_NO",
      "KC_TRNS",
      "KC_NO"
    ],
    [
      "KC_TRNS",
      "KC_TRNS",
      "KC_TRNS",
      "KC_NO",
      "KC_TRNS",
      "KC_TRNS",
      "KC_TRNS",
      "KC_TRNS",
      "KC_TRNS",
      "KC_TRNS",
      "KC_TRNS",
      "KC_TRNS",
      "KC_TRNS",
      "KC_TRNS",
      "KC_TRNS",
      "KC_NO",
      "KC_TRNS",
      "KC_TRNS",
      "KC_TRNS",
      "KC_TRNS",
      "KC_TRNS",
      "KC_NO",
      "KC_TRNS",
      "KC_NO"
    ],
    [
      "KC_TRNS",
      "KC_TRNS",
      "KC_TRNS",
      "KC_NO",
      "KC_TRNS",
      "KC_TRNS",
      "KC_TRNS",
      "KC_TRNS",
      "KC_TRNS",
      "KC_TRNS",
      "KC_TRNS",
      "KC_TRNS",
      "KC_TRNS",
      "KC_TRNS",
      "KC_TRNS",
      "KC_NO",
      "KC_TRNS",
      "KC_TRNS",
      "KC_TRNS",
      "KC_TRNS",
      "KC_TRNS",
      "KC_NO",
      "KC_TRNS",
      "KC_NO"
    ]
  ]
}
